The Locust
An Interactive Fiction by Mackenzie Norman
Release 1 / Serial number 250505 / Inform 7 v10.1.2 / D

Ks room
Sitting on the couch in the dark.   K. is well aware it's the last last beer. 

You can see a last beer here.

>drink beer
K. drinks the beer  damn.  I.  have to get more

>look
Ks room
Sitting on the couch in the dark.

* * *

The Locust
An Interactive Fiction by Mackenzie Norman
Release 1 / Serial number 250505 / Inform 7 v10.1.2 / D

Ks room
Sitting on the couch in the dark.   K. is well aware it's the last last beer. 

You can see a last beer here.

>drink last beer
K. drinks the last beer
  damn.  I.  have to get more

>outside
thoughtland

* * *

The Locust
An Interactive Fiction by Mackenzie Norman
Release 1 / Serial number 250505 / Inform 7 v10.1.2 / D

Ks room
Sitting on the couch in the dark.   K. is well aware it's the last last beer. 

You can see a last beer here.

>look
Ks room
Sitting on the couch in the dark. K. is well aware it's the last beer.

>x
What do you want to examine?

>x beer
You can't see any such thing.

* * *

The Locust
An Interactive Fiction by Mackenzie Norman
Release 1 / Serial number 250505 / Inform 7 v10.1.2 / D

Ks room
Sitting on the couch in the dark.   K. is well aware it's the last last beer. 

You can see a last beer here.

>take beer
damn.  I.  have to get more

>look
Ks room
Sitting on the couch in the dark.

>i
You are carrying nothing.

>look K
You can't see any such thing.

>purloin K
[Purloined.]

>k
That's not a verb I recognise.

>x k
In K is a last beer.

>take last beer
damn.  I.  have to get more

* * *

>take beer
damn.  I.  have to get more

>take beer
You can't see any such thing.

>look beer
You can't see any such thing.

>out
But you aren't in anything at the moment.

* * *

The Locust
An Interactive Fiction by Mackenzie Norman
Release 1 / Serial number 250505 / Inform 7 v10.1.2 / D

Ks room
Sitting on the couch in the dark.   K. is well aware it's the last last beer. 

You can see a last beer here.

>take lat beer
You can't see any such thing.

>take  beer
damn.  I.  have to get more

>purloin k
[Purloined.]

>take  beer
You can't see any such thing.

>x k
K is empty.

* * *

The Locust
An Interactive Fiction by Mackenzie Norman
Release 1 / Serial number 250505 / Inform 7 v10.1.2 / D

Ks room
Sitting on the couch in the dark.   K. is well aware it's the last last beer. 

You can see a last beer here.

>x beer
a 16oz narrangansett.

* * *

The Locust
An Interactive Fiction by Mackenzie Norman
Release 1 / Serial number 250505 / Inform 7 v10.1.2 / D

Ks room
Sitting on the couch in the dark.   K. is well aware it's the last last beer. 

You can see a last beer here.

>x beer
You can't see any such thing.

>look
Ks room
Sitting on the couch in the dark. K. is well aware it's the last beer.

* * *

>x
What do you want to examine?

>x room
You can't see any such thing.

>x a beer
You can't see any such thing.